Al James - Schoolboy Facination.stem
AM Contra - Heart Peripheral.stem
Angels In Amplifiers - I'm Alright.stem
Arise - Run Run Run.stem
Ben Carrigan - We'll Talk About It All Tonight.stem
BKS - Bulldozer.stem
BKS - Too Much.stem
Bobby Nobody - Stitch Up.stem
Buitraker - Revo X.stem
Carlos Gonzalez - A Place For Us.stem
Cristina Vane - So Easy.stem
Detsky Sad - Walkie Talkie.stem
Enda Reilly - Cur An Long Ag Seol.stem
Forkupines - Semantics.stem
Georgia Wonder - Siren.stem
Girls Under Glass - We Feel Alright.stem
Hollow Ground - Ill Fate.stem
James Elder & Mark M Thompson - The English Actor.stem
Juliet's Rescue - Heartbeats.stem
Little Chicago's Finest - My Own.stem
Louis Cressy Band - Good Time.stem
Lyndsey Ollard - Catching Up.stem
M.E.R.C. Music - Knockout.stem
Moosmusic - Big Dummy Shake.stem
Motor Tapes - Shore.stem
Mu - Too Bright.stem
Nerve 9 - Pray For The Rain.stem
PR - Happy Daze.stem
PR - Oh No.stem
Punkdisco - Oral Hygiene.stem
Raft Monk - Tiring.stem
Sambasevam Shanmugam - Kaathaadi.stem
Secretariat - Borderline.stem
Secretariat - Over The Top.stem
Side Effects Project - Sing With Me.stem
Signe Jakobsen - What Have You Done To Me.stem
Skelpolu - Resurrection.stem
Speak Softly - Broken Man.stem
Speak Softly - Like Horses.stem
The Doppler Shift - Atrophy.stem
The Easton Ellises (Baumi) - SDRNR.stem
The Easton Ellises - Falcon 69.stem
The Long Wait - Dark Horses.stem
The Mountaineering Club - Mallory.stem
The Sunshine Garcia Band - For I Am The Moon.stem
Timboz - Pony.stem
Tom McKenzie - Directions.stem
Triviul feat. The Fiend - Widow.stem
We Fell From The Sky - Not You.stem
Zeno - Signs.stem
